R 1200 1000
1111111111
1020000001
1001010101
10000000N1
1000000001
1111111111