R 10 10

NO textures/bluestone.xpm
SO textures/wall_1.xpm
WE textures/wall_2.xpm
EA textures/wood.xpm

S textures/sprite_1.xpm
F 55,100,4
C ,37,125

1111111111
1000000201
102k102021
1000000001
1000200N21
1111111111