R 1000 1000
1111111111
100N000001
1000000001
1000000001
1000000001
1000000001
1000000001
1000000001
1000000001
1111111111