R 600 420

NO textures/bluestone.xpm
SO textures/wall_1.xpm
WE textures/wall_2.xpm
EA textures/wood.xpm

S textures/sprite_1.xpm
F 55,100,4
C 80,37,125

01111111111111
10000000000001
12012101010101
12001000001001
12000000011101
1200N000020001
11111111111111