R 800 100
1111111111111111111111111111111111111
1000001000000011110000000000000000001
1001010100000000000111111000111111001
1001000111110000000000000000001001011
1001110000001100010001111111111000001
1000000111100000000000000001000000001
111111100011110100000000N001001000001
1111111010000000111110000001001000001
1000000010111110000000000000000000001
1111111111111111111111111111111111111