R 1000 1000
111111
10N001
101011
100001
111111