            R 10 10

NO textures/bluestone.xpm
SO textures/wall_1.xpm
WE textures/wall_2.xpm
EA textures/wood.xpm

S textures/sprite_2.xpm
F 55,100,4
C 155,37,125

1111111111
1000002001
1020102221
1002000N01
1000200021
1111111111