R 1000 1000
11111111111111
10000000000001
10010101010101
10000000000101
1000N000011101
10000000000001
11111111111111