R 1000 1000

NO textures/bluestone.xpm
SO textures/metal.xpm
WE textures/eagle.xpm
EA textures/wall_wood.xpm

S ./path_to_the_sprite_texture
F 220,100,0
C 225,30,0

11111111111111
10000000000001
10010101010101
10000000000101
10000000011101
1000N000000001
11111111111111