R 1920 1080
111111
100101
102001
1100N1
111111
