            R  680 450
NO textures/bluestone.xpm
SO textures/wall_1.xpm
WE textures/wall_2.xpm
EA textures/wood.xpm

S textures/sprite_1.xpm
F  55,0,4
C 45,0,125

        1111111111111111111111111
        1000000000110000000000001
        1011000001110000002000001
        1001000000000000000000001
111111111011000001110000000000001
100000000011000001110111110111111
11110111111111011100000010001
11110111111111011101010010N01
11000000110101011100000010001
10002000000000001100000010001
10000000000000001101010010001
1100000111010101111101111000111 
11110111 1110101 101111010001
11111111 1111111 111111111111