            R 600 600

NO textures/bluestone.xpm
SO textures/wall_1.xpm
WE textures/wall_2.xpm
EA textures/wood.xpm

S textures/sprite_1.xpm
F  55,0,4
C 45,0,125

1111111111
1000000001
1020102221
1002000N01
1000200021
1111111111