R 600 420

NO textures/bluestone.xpm
SO textures/wall_1.xpm
WE textures/wall_2.xpm
EA textures/wood.xpm

S textures/sprite_1.xpm
F 55,100,4
C 80,37,125

11111111111111
10000000000001111
12012101010100001
12001000001001111
12000S00011101
12000000020001
11111111111111