R 1980 1420

NO textures/bluestone.xpm
SO textures/wall_1.xpm
WE textures/wall_2.xpm
EA textures/wood.xpm

S textures/sprite_2.xpm
F 220,100,0
C 225,30,0

111111111111111111111111111111111111111111111111
1000W0000000011100001010100010011010101111000001
100101010100000000000101011101010000010101110101
100111000010101000100110101000110110000020000101
100000111000010101000100110101000110000000011101
100001010111010100000010101110101000001010111011
1000W0000101011101010111101011000100110000000011
1011010101110010000010101101010111010000E0000101
101100010000110110000000000111100001101000000101
100000001010001100011001010000011000000000011101
111101011000110010100000001111000011010000000001
100000000010000000100001010111010110111010100001
101001100111001110100001110010000110100000000101
100011001000001100100000000000000000000000000101
111110000101000001000001001110000110100000011101
100000110001000111111100000000000000000000000001
111111111111111111111111111111111111111111111111