R 1 1

NO textures/bluestone.xpm
SO textures/wall_1.xpm
WE textures/wall_2.xpm
EA textures/wood.xpm

S textures/sprite_1.xpm
F 55,100,4
C 80,37,125

111111111111111111111111111111111111111111111111
100000000000000000000000000000000000000000000001
100101010100000000000101011101010000010101110101
100111000010101000100110101000110110000020000101
100000111000010101000100110101000110000000011101
100001010111010100000010101110101000001010111011
100000000101011101010111101011000100110000000001
101101010111001000001010110101011101000000000101
10000100020011011000000N000111100001101000000101
100000001010001100011001010000011000000000011101
100000011000110010100000001111000011010000000001
100000000010000000100001010111010110111010100001
100000100000001110100001110010000110100000000101
100001001000001000100000000000000000000000000101
100010000100000001000001001110000110100000011101
100000000000000000000000000000000000000000000001
111111111111111111111111111111111111111111111111